1 1
6 5
########
#.....##
#####.##
#.#...##
#.#.####
#......#
########