1 1
3 20
#########################
#.....##................#
#####.##..#.............#
#.#...##..#.............#
#.#.####..#.............#
#.........#.............#
#########################